  #####
  #   ##
### #  #
#  $   ##
#  $ $  #####
#  $ $  ##  #
####$#####  #
  #  #.  .  #
  #   . @. ##
  ####. #. #
     #######