#######
#@   ##
# $$..#
## $$.#
#.   .#
#.$$.##
# .$$ #
##    #
#######