#######
#   @ #
# $   #
#   $ #
#   . #
# .   #
#######