#######
#   @ #
# $   #
#   $ #
#   . #
#     #
#     #
# .   #
#######