   ####          
  ##  ###########
###             #
#  +******####  #
#  *         # ##
## *         # # 
 # *  *******# # 
 # *  *   #    # 
 # *  * # #### # 
 # *  *  $     # 
 # #  *## #### # 
 # #  * # #  # # 
 # #  * # #  # # 
 # #### # #### # 
 #             # 
 #  ############ 
 ####            