easy
######
##   #
#+ $ #
## . #
######