easy
######
##   #
#^ x #
## o #
######