easy
######
##   #
#@ $ #
## . #
######