#######
#  .  #
# $@  #
#     #
#######