example1
######
#  . #
# $+ #
#  ###
######