######
#  . #
# $@ #
#  ###
######