  ###         
 #  @##       
#  $$ # #     
##  $  ##     
  # $    ###  
 ##  #.*.  #  
   # #*$*$  ##
   #  .$. ##  
 # ## ...#    
 ##  ### #    
       # #    
        # 