   #   #   
  ## # ##  
 #  ###  # 
##   $ @###
 #  .*.  # 
# #$* *$# #
# # .$. # #
 # $...$ # 
##   $   ##
 #  ###  # 
  ## # ##  
   #   #   