    ###   
  # # #   
 ###   #  
# # .*. ##
#   *$*  #
 ## *@* ##
  # ...#  
   # $$ # 
   # $  ##
 ##  $   #
  # ##  # 
  ## # ## 
     ## 