normal
#########
##   ####
##   #  #
###    o#
### ###o#
# x ###o#
# xx#####
#^  #####
#########
