normal
#########
##   ####
##   #  #
###    .#
### ###.#
# $ ###.#
# $$#####
#+  #####
#########
