petite
  ###   ###
 ##### #####
##...###...##
# ... # ... #
# $$$$$$$$$ #
##         ##
 ## $$$$$ ##
  ##     ##
   ##. .##
    ##@##
     ###
      #