     #####
     #   ##
   ###$$  ##
   #   #   ##
   # $   #  ##
###### # ##  #
#..  # $ $   #
#..  $   #####
#+.  #####
######