#####
#   #
#.*.###
#  *  #
# $.**#
#  $ ##
# $ ##
#@ ##
####