#####
#   ##
#@   #
##$$ #
#  $ #
## ###
#   ##
## . #
# * .#
#  .##
##   #
 #####