####
#  ####
#+$.  ##
# *$$  #
#  *   #
#  #. ##
#######