 #######
## #. .#
#  $ . #
# $#.$.#
#  $ . #
## #$ ##
# $  ##
#   ##
#@ ##
####