 #####
##   #
# $# ##
#  . @#
##... #
#  $ ##
# $###
#  $ #
##   #
 #####