 ####  ####
##  ####  ##
#       $  #
# ..# $  $@#
# . ####$$ #
#.. #  #   #
#####  #####