      #####
      #   #
#######$$ #######
#..#  # $ #  #..#
#*.$  $ @ $  $.*#
#..   # $ #   ..#
#######$$ #######
      #   #
      #####