#######
#     #
# $+$ #
#.*#*.#
# $.$ #
#     #
#######