 #####
##   ##
#  *  #
# .$. #
# $*$ #
# .#. #
# $*$ #
# .$. #
#  * @#
##   ##
 #####