   ######
   #    #
####$ $$####
#  ......  #
#  .$$$$.  #
# $.   $.  #
#  .$$$$.  #
#  .$   .$ #
#  .$$$$.  #
#  ......  #
####$$@$####
   #    #
   ######