#####
#   ######
# $$#  ..#
#   $  ..#
# $$#  .+#
#   ######
##  #
 #  #
 #$ #
 #  #
 ####