##########
#        #
# $$ $  @#
# $  #  ####
##$$ ## .  ##
#   ##   .  #
#    #..  ..#
#############