######
# .  ##
#@ *$ ##
##  .  ##
 ## $*$ ##
  ##  .  #
   ##  * #
    ##   #
     ## ##
      ###