  #########  
### ..    ###
#   #.# #   #
#  $$*$$$   #
### .+   ####
  ########   