 ###### 
 #  .@##
 #   $.#
 ###.# #
##  $  #
#  $  ##
#   ### 
#####