    #####    
    #   #    
 #### # #####
##   $ $    #
# $# #...#$ #
#@$  ...#  ##
# $#.*.# $  #
##   .#     #
 ### $ $ #  #
   ###   ####
     #####   