########
# $..$ #
# $..$ #
# $..$ #
#   # @#
########