     #####  
######   ## 
#+  *  $  ##
#### ##  * #
   #  ###  #
   ##  #  ##
    ##   ## 
     #####  