soko_1
###############
#######o#######
#######o#######
###         ###
##  # # # #  ##
#  ##     ##  #
# ##  # #  ## #
#     x^x     #
####  ###  ####
###############
