  #####         
  #   #         
### $@##        
# $ #  #        
#  $ $ #    ####
###  #$##   #  #
  #   $ #####$ #
  ##           #
   ##$$$##$##  #
    #         ##
    #  ######## 
   ### ##       
   #    #       
   #. ..#       
  ##.#..#       
  #.....#       
  ####### 