###############
#######.#######
#######.#######
###         ###
##  # # # #  ##
#  ##     ##  #
# ##  # #  ## #
#     $@$     #
####  ###  ####
###############
