        #####
     ####   #
     #  # $ ##
     #    $$ #
     # ##    #
###### #######
#    # #
# .+.  ####
# ###     #
# ### #   #
#     #####
#######