    ####
    #  ### ####
    # $  ###  ###
  ###..   .$ *$.#
###..###.# $ $  ##
# .$ . $ #.$ . . #
#  $.#$$$#  ######
# .$$# $ . ##
### .#.###$####
  #. $ * .  $ #
  #  $    $.$.##
 ##$$$$### $*  #
##.$.$.# ##.$+ #
# . . .#  #   ##
########  #####