trying
######
## ..#
##  .#
# $$##
# $+##
#   ##
######