trying
######
## ..#
##  .#
# $$##
# $@##
#   ##
######