trying
######
## oo#
##  o#
# xx##
# x^##
#   ##
######